TEA = "countries/Theresa.txt"
THL = "countries/Theresa_THL.txt"
TBG = "countries/Theresa_TBG.txt"
TFR = "countries/Theresa_TFR.txt"
TAS = "countries/Theresa_TAS.txt"
TYL = "countries/Theresa_TYL.txt"
TTA = "countries/Theresa_TTA.txt"
THN = "countries/Theresa_THN.txt"
TBP = "countries/Theresa_TBP.txt"
TER = "countries/Theresa_TER.txt"
TPL = "countries/Theresa_TPL.txt"
TNE = "countries/Theresa_TNE.txt"
TBS = "countries/Theresa_TBS.txt"
TBL = "countries/Theresa_TBL.txt"
TUI = "countries/Theresa_TUI.txt"
TBT = "countries/Theresa_TBT.txt"
TNF = "countries/Theresa_TNF.txt"
TWF = "countries/Theresa_TWF.txt"
TMF = "countries/Theresa_TMF.txt"
TEF = "countries/Theresa_TEF.txt"
TSF = "countries/Theresa_TSF.txt"
TAL = "countries/Theresa_TAL.txt"
TME = "countries/Theresa_TME.txt"
TNA = "countries/Theresa_TNA.txt"
TSA = "countries/Theresa_TSA.txt"
TID = "countries/Theresa_TID.txt"
TES = "countries/Theresa_TES.txt"
TAU = "countries/Theresa_TAU.txt"
TPO = "countries/Theresa_TPO.txt"
TMK = "countries/Theresa_TMK.txt"
TMA = "countries/Theresa_TMA.txt"
TSB = "countries/Theresa_TSB.txt"
TFA = "countries/Theresa_TFA.txt"
TCH = "countries/Theresa_TCH.txt"
TJP = "countries/Theresa_TJP.txt"